XXXXXXXXXXXXXXXXXXXXXXXXX
X             X       XXX
X  XX X XXX X XXX X XXXXX
X X   X X X  X          X
X X   XX X X      X XXXXX
X X X     X X   X X     X
X X XXXXXXX XXXXX XXXXX X
X X       X     X     X X
X    XXXX XXXXX XXXXX X X
X     X   X   X     X X X
XXXXX X     X XXXXX X X X
X   X X   X X X   X X   X
X X X XXX X X X X XXXXX X
X   X X   X X X X     X X
X X X X XXXXX X XXXXX X X
X X X X   X   X     X   X
X X X XXXXX XXXXX XXXXXXX
X      XX    X          X
XXXXXXXXXXXXXXXXXXXXXXXXX

